███████████████████████████████████████G███████████████████████████████████████
███████████████████████████████████████ ███████████████████████████ ███████████
███       █████████████████████████████ ███████████████████████████           █
█████████ █████████████████████████████ ███████████████████████████ ███████████
█████████ █████████                                          ██████ ███████████
█████████ █████████ ███████ ███████████████████████████████████████ ███████████
█████████ █████████ ███████ ███████████████████████████████████████ ███████████
██████              ███████ █████████████████████████               ███████████
███████████████████ ███████ █████████████████████████ █████████████████████████
███████████████████ ███████ █████████████████████████ █████████             ███
███████ ███████████ ███████             █████████████ █████████ ███████████ ███
███████ ███████████ █████████████████████████████████ █████████ ███████████ ███
███████ ███████████ █████████████████████████████████           ███████████ ███
███████ ███████████ █████████████████████████████████████████████████████   ███
███████ ███████████ █████████████████████████████████████████████████████ █████
███████ ███████████ ███████████████████████████████████████████ █████████ █████
███████                         ███████████████████████████████           █████
███████████ ███████████████████ ███████████████████████████████ ███████████████
███████████ ███████████████████ ███████████████████████████████ ███████████████
███████████ ███████████████████                  ██████████████ ███████████████
███████████ ████████████████████████████████████ ██████████████ ███████████████
█           ████████████████████████████████████ ██████████████ ███████████████
█ █████ ████████████████████████████████████████                ███████████████
█ █████████████████████████████████████████████████████████████████████████████
█S█████████████████████████████████████████████████████████████████████████████